%%%%%%%%%%%%%%%%%%%%
%.....        .... %
%.%% % % %%%% %.%%.%
%....% %..o...%.o%.%
%.%%.%.% .%%% %..%.%
%o......P.........G%
%.%%.%.% .%%% %..%.%
%....% %..o...%.o%.%
%.%% % % %%%% %.%%.%
%.....         ....%
%%%%%%%%%%%%%%%%%%%%