%%%%%%%%%%%%%%%%%%%%
%  ....     ....   %
%...  ... ...  ... %
%...  ... ...  ... %
%...  ... ...  ... %
% G....     ....P  %
%...  ... ...  ... %
%...  ... ...  ... %
%...  ... ...  ... %
%  ....      .... o%
%%%%%%%%%%%%%%%%%%%%