%%%%%%%%%%%%%%%%%%%%
%  ....     ....  P%
%...  ... ...  ... %
%...  ... ...  ... %
%...  ... ...  ... %
%  .... o o ....   %
%...  ... ...  ... %
%...  ... ...  ... %
%...  ... ...  ... %
%G ....      ....  %
%%%%%%%%%%%%%%%%%%%%