%%%%%%%%%%%%%%%%%%%%%%
%  .                 %
% %%%%%%%%G%%%% %%%% %
%   .                %
% %%%%%%%G G%%% %%%% %
%    .               %
% %%%%%%G% %G%% %%%% %
%     .             P%
% %%%%%G%G G%G% %%%% %
%                    %
%%%%%%%%%%%%%%%%%%%%%%