%%%%%%%%%%%%%%%%%
%              .%
% %%%%%%%%% %GG%%
% %%.          .%
% %G%%%%%%%%%GG %
%       P       %
%%%%%%%%%%%%%%%%%