%%%%%%%%%%%%%%%%%
%              .%
%%%%%%%%%%P%GGG%%
%.              %
%%GG% %%%%%%%%G%%
%              .%
%%%%%%%%%%%%%%%%%