%%%%%%%%%%%%%%%%%
%              .%
% %%%%%%%%%P%GG%%
% %%.          .%
% %G%%%%%%%%%GG %
%               %
%%%%%%%%%%%%%%%%%