%%%%%%%%%%%%%%%
%.           .%
%%%%G        G%
%.     P      %
%%%%G        %%
%.           .%
%%%%%%%%%%%%%%%