%%%%%%%%%%%%%%%
%.           .%
%%%%G        G%
%.            %
%%%%G        %%
%.   P       .%
%%%%%%%%%%%%%%%