%%%%%%%%%%%%%%%
%            .%
% G% %G% %GGG %
% %   %   %%% %
% % % % % %   %
%P  %   %    .%
%%%%%%%%%%%%%%%