%%%%%%%%%%%%%%%
%            .%
% G% %G% %GGG %
% %   %   %%% %
% % % % % %   %
%   % P %   %.%
%%%%%%%%%%%%%%%