%%%%%%%%%%%%%%%
%.           .%
%%%%G        G%
%.           P%
%%%%G        %%
%.           .%
%%%%%%%%%%%%%%%