%%%%%%%%%%%%%%%
%            .%
% G% %G% %GGG %
% % P %   %%% %
% % % % % %   %
%   %   %   %.%
%%%%%%%%%%%%%%%