%%%%%%%%%%%%%%%%%%%%%%%%%%%%%%
%                           .%
%%%%%%%%%%%%%%%%%%%%%% %GGGG%%
%.                           %
%%GGG%P%%%%%%%%%%%%%%%%%%%%%%%
%                           .%
%%%%%%%%%%%%%%%%%%%%%%%% %GG%%
%.                           %
%%G% %%%%%%%%%%%%%%%%%%%%%%%%%
%                            %
%%%%%%%%%%%%%%%%%%%%%%%%%%%% %
%                            %
% %%%%%%%%%%%%%%%%%%%%%%%%%%%%
%                           .%
%%%%%%%%%%%%%%%%%%%%%%%%%%%%%%