%%%%%%%%%%%%%%%%%%%%%%
%   %%      %%%G    P%
% %    %%%  %.       %
% %%%%%%%G  G%GG%%%% %
%    %   %  %   %    %
%  G   G  ..  G   G  %
%    %   %  %   %    %
% %%%%%%%G  G%%%%%%% %
% %   %   %   %   %  %
%   %   %   % %      %
%%%%%%%%%%%%%%%%%%%%%%