%%%%%%%%%%%%%%%%%%%%%%
%                    %
% %%%%%%%%%%%%%%%%%% %
%                  % %
% %%%%%%%%%%%%%%%% % %
% G         .      % %
% %%%%%%%G G%%%%%%%% %
%                 .% %
% %%%%%%%%%%%%%%%%%% %
%                   P%
%%%%%%%%%%%%%%%%%%%%%%